XXXXXXXXXXXXXXXXXXXXX
X...................X
X...................X
X...................X
XXXXXXXXXXX.........X
          X.........X
          X.........X
          X.........X
          X.........X
          XXXXXCXXXXX
          XXXXXXXXXXX