XXXXXXXXXXXX
X..........X
X..........X
X..........X
X..........X
X..........X
X....C.....X
X..........X
X..........X
X..........X
X..........X
XXXXXXXXXXXX
XXXXXXXXXXXX