XXXXXXXXX
XC......X
X.X.X.X.X
X.X.X.X.X
X.......X
XXXXXXXXX