XXXXXXXXX
X.C.....X
X.X.X.X.X
X.X.X.X.X
X.......X
XXXXXXXXX