XXXXXXXXX
X......CX
X.X.X.X.X
X.X.X.X.X
X.......X
XXXXXXXXX