XXXXXXXXX
X.......X
X.X.X.X.X
X.X.X.XCX
X.......X
XXXXXXXXX