XXXXXXXXX
X.......X
X.X.X.X.X
X.X.X.X.X
X......CX
XXXXXXXXX