XXXXXXXXX
X.......X
X.X.X.X.X
X.X.X.X.X
X..C....X
XXXXXXXXX