XXXXXXXXX
X.......X
XCX.X.X.X
X.X.X.X.X
X.......X
XXXXXXXXX