XXXXXXXXX
X.......X
X.X.X.X.X
X.X.X.X.X
XC......X
XXXXXXXXX