XXXXXXX
X....CX
X.X.X.X
X.....X
X.X.X.X
X.....X
XXXXXXX