XXXXX
X...X
X.X.X
X...X
X.X.X
XC..X
XXXXX