XXXXX
X...X
X.X.X
X...X
X.X.X
X.C.X
XXXXX