XXXXX
X.C.X
X.X.X
X...X
X.X.X
X...X
XXXXX