XXXXX
X...X
X.X.X
X..CX
X.X.X
X...X
XXXXX