XXXXX
X...X
X.X.X
X...X
X.XCX
X...X
XXXXX