XXXXXXX
X.....X
X.X.X.X
X.....X
X.X.X.X
X...C.X
XXXXXXX