XXXXXXX
X.....X
X.X.XCX
X.....X
X.X.X.X
X.....X
XXXXXXX