XXXXX
X...X
X.X.X
XC..X
X.X.X
X...X
XXXXX