XXXXXXX
X.....X
X.X.X.X
X.....X
X.X.X.X
XC....X
XXXXXXX