XXXXXXX
X.C...X
X.X.X.X
X.....X
X.X.X.X
X.....X
XXXXXXX