XXXXX
X...X
X.X.X
X...X
X.X.X
X..CX
XXXXX