XXXXXXX
X.....X
X.X.X.X
X.....X
X.X.X.X
X....CX
XXXXXXX