XXXXX
X...X
XCX.X
X...X
X.X.X
X...X
XXXXX