   XXXXXXXXXXX
   X.........X
XXXX.........XXXX
X...............X
X...............X
XXXX.........XXXX
   x.........X
   X.........X
   XXXXXCXXXXX
   XXXXXXXXXXX