XXXXXXX
X.....X
X.....X
X.....X
XXXCXXX
XXXXXXX