XXXXXXXXXX
X........X
X.XXXXXX.X
x.x    X.X
X.X  XXX.X
XCX  X...X
XXX  XXXXX
