         XXXXXXXXXXX
         X.........X
         X.........X
         X.........X
XXXXXXXXXX.........XXXXXXXXXXXX
X.............................X
X.............................X
X.............................X
XXXXXXXXXX.........xXXXXXXXXXXX
         x.........X
         X.........X
         X.........X
         X.........X
         XXXXXCXXXXX
         XXXXXXXXXXX