XXXXXXXXXXXX
X..........X
X..........X
X..........X
X..........X
X..........X
X..........X
X..........X
X..........X
X..........X
X..........X
XXXXXCXXXXXX
XXXXXXXXXXXX